................
.......#######..
.......#........
..A....#..B.....
.......#........
.......#######..
................
