...#.#.#........
.A.#...#.#......
...#.#.#.#......
...#.#.#.#......
...#.#.#.#......
.....#.#.#...B..
...#.#...#......
